00000000008000000000
00000000111100000000
00800000000000000000
11111008000000000000
00000001111009000080
00000000000001000111
00000000000000000000
00008000000111000000
00011110000000000000
00000000110000000000
11111111111111111111